####################################################################################################
#..................................................................................................#
#..................................................................................................#
#..................................................................................................#
#..................................................................................................#
#..................................................................................................#
#............###...................................................................................#
#..................................................................................................#
#..................................................................................................#
#..................................................##..............................................#
#................................................#..#..............................................#
#................................................####..............................................#
#..............................#####...............................................................#
#..................................................................................................#
#..................................................................................................#
#..................................................................................................#
#..................................................................................................#
#..................................................................................................#
#..................................................................................................#
####################################################################################################